mandem	mandem
man dem	mandem
man-dem	mandem
wasteman	wasteman
waste man	wasteman
brudda	brudda
bruddah	brudda
brother|collq	brudda
re:\bbrudd?a(h)?\b	brudda
ends	ends
da ends	ends
ting	ting
tâ€™ing	ting
thingz	ting
inna	inna
road man	roadman
roadman	roadman
peng	peng
skeng	skeng
skengman	skengman
gyal	gyal
yard	yard
bare	bare
creps	creps
link up	link up
link-up	link up
skrrt	skrrt
